xxxxxxxxxxxxxxxx
x              x
x              x
x v v  vv   v  x
x    p  xsx v  x
x           v  x
x xxx  xsx     x
x xps  xvx     x
x xx   xxx     x
x    s         x
x            sfx
xxxxxxxxxxxxxxxx
