xxxxxxxxxxxxxxxx
x             fx
x              x
x         s    x
x   xxxx       x
x   xv x       x
x   xx x  x xx x
x         x sx x
x    v    xxxx x
x     xsxv     x
x     xxx      x
xxxxxxxxxxxxxxxx
