xxxxxxxxxxxxxxxx
x            sfx
x    v      x  x
x           x  x
x   x   s xxx  x
x              x
x      x       x
x xvxsxvxs     x
x  p      v  p x
x              x
x              x
xxxxxxxxxxxxxxxx
